30 60
4 21
___________________________________________________________
|||||||||||||||||||||   |||||||| ||||| |||||| |||||| ||||||
|||||||||             |||||||||  |||    ||||   |||       ||
||||||||   |||||||||   |  | | |  ||||   ||||   |||       ||
||||||    |||||||||              ||||   |||    |||       ||
||||||   ||||||||||||||||||||||  ||||   ||||     ||||||  ||
|||||    ||||||||||||||||||||||                           |
|||||||  ||||||||||||||||||||||||||||||||||||||||||||||  ||
||||||    |||||||||              ||||   |||    |||       ||
||||||   ||||||||||||||||||||||  ||||   ||||     ||||||  ||
|||||    ||||||||||||||||||||||                           |
|||||||  ||||||||||||||||||||||||||||||||||||||||||||||  ||
||||||    |||||||||              ||||   |||    |||       ||
||||||   ||||||||||||||||||||||  ||||   ||||     ||||||  ||
|||||    ||||||||||||||||||||||                           |
|||||||  ||||||||||||||||||||||||||||||||||||||||||||||  ||
||||||    |||||||||              ||||   |||    |||       ||
||||||   ||||||||||||||||||||||  ||||   ||||     ||||||  ||
|||||    ||||||||||||||||||||||                           |
|||||||  ||||||||||||||||||||||||||||||||||||||||||||||  ||
|||||||||             |||||||||  |||    ||||   |||       ||
||||||||   |||||||||   |  | | |  ||||   ||||   |||       ||
||||||    |||||||||              ||||   |||    |||       ||
||||||   ||||||||||||||||||||||  ||||   ||||     ||||||  ||
|||||||||             |||||||||  |||    ||||   |||       ||
||||||||   |||||||||   |  | | |  ||||   ||||   |||       ||
||||||    |||||||||              ||||   |||    |||       ||
||||||   ||||||||||||||||||||||  ||||   ||||     ||||||  ||
|||||    ||||||||||||||||||||||||||||||||||||||||||||||
||||   ||||||||||||||||||||||||||||||||||||||||||||||||||||